28 49
@@@@@@@@@@@@@@@@@@@@@@@@@@@@@@@@@@@@@@@@@@@@@@@@@
....................@@@@@@@@@@@@@@@@@@@@@@@@.....
......................@@@@@@@@@@@@@@@@@@@@.......
@@@..@@@..@@@@@@@..@.....@@@@@@@@@@@@@@@.........
@@@..@@@........@..@@@.......@@@@@@@........@@@@@
@@@..@@@........@..@@@@.................@@..@@@@@
@@@..@@@..@@@@@@@..@@@@..@@@@.......@@@@@@..@@@@@
@@@..@@@..@@@@@@@..@@....@@@@@@@@@@.@@@@@@..@@@@@
@@@................@@....@@@@@@@@@@.@@@@@@..@@@@@
@@@..@@@...........@@@@.............@@@@@@..@@@@@
@@@..@@@..@@@@@@@@@@@@@..@@@@@@@@@@@........@@@@@
@@@.......@@@@@@@@@@@@@..@@@@@@@@@@@........@@@@@
@@@..@@@..............................@@@@..@@@@@
@@@..@@@..............................@@@@..@@@@@
@@@..@@@..@@@@@@.@@@@@@@@@@@@@@@@@..........@@@@@
@@@.......@@@@@@.@@@@@@.....................@@@@@
@@@.................................@@@@@@@.@@@@@
@@@......................@@@@@@@..@@@@@@@@@.@@@@@
@@@.......@@.@@..@@@..@..@@@@@@@..@@@@@@......@@@
@@@..@@@..@@.@@..@@@..@..@..........@@@...@@...@@
@@@.......@@.@@.......@..@...............@@@@..@@
@@@..@@@..@@.@@..@@@..@..@..@@@..@@@@@@..@@@@..@@
@@@..@@@..@@.@@..@@@..@..........@@@@@@...@@...@@
@@@...........................................@@@
@@@..........................................@@@@
@@@..@@@..@@@@@..@@@..@..@@@@@@@@@@@@@@@@@@.@@@@@
.................................................
@@@@@@@@@@@@@@@@@@@@@@@@@@@@@@@@@@@@@@@@@@@@@@@@@
1
17 11 1 48